みせる	miseru	見せる	to show; to display
かぎ	kagi	鍵	key / lock
ふるい	furui	古い	old; aged; ancient; antiquated; antique; timeworn / long; since long ago; time-honored / of the distant past; long-ago / stale; threadbare; hackneyed; corny / old-fashioned; outmoded; out-of-date
ごはん	gohan	ご飯	cooked rice / meal
こうばん	kouban	交番	police box; small neighborhood police station / alternation; alternating (e.g. current)
あつい	atsui	厚い	thick; deep; heavy / kind; cordial; hospitable; warm; faithful / serious (of an illness) / abundant
むこう	mukou	向こう	opposite side; other side; opposite direction / over there; that way; far away; beyond / the other party; the other person / future (starting now)
ふる	furu	降る	to fall (of rain, snow, ash, etc.); to come down / to form (of frost) / to beam down (of sunlight or moonlight); to pour in / to visit (of luck, misfortune, etc.); to come; to arrive
くろい	kuroi	黒い	black / dark; blackish; sun-tanned (skin) / suspicious; criminal; illicit / darkened and dirty; sooty; covered in dirt / evil; wicked; black-hearted / inauspicious; ill-boding; unlucky
こんばん	konban	今晩	tonight; this evening
こまる	komaru	困る	to be troubled; to be worried; to be bothered; to be embarrassed; to be stumped
さす	sasu	差す	to shine / to be visible / to be tinged with / to rise (of water levels); to flow in / to be felt (i.e. as an emotion); to come over one / to hold up (an umbrella, etc.); to put up; to raise / to extend one's arm straight ahead (in dance) / to insert; to put in / to wear (a sword) in one's belt; to wear at one's side; to carry under one's arm / to insert one's arm under an opponent's arm / to pole (a boat) / to pour; to add (liquid); to serve (drinks) / to put on (lipstick, etc.); to apply; to colour; to dye / to light (a fire); to burn / to shut; to close; to lock; to fasten / to stop in the midst of; to leave undone
すわる	suwaru	座る	to sit; to squat / to assume (a position) / to hold steady; to hold still
さらいねん	sarainen	再来年	year after next
ほそい	hosoi	細い	thin; slender; fine / unlucky (billiards slang)
とる	toru	撮る	to take (a photo) / to record (video, audio, etc.); to make (a film)
はじまる	hajimaru	始まる	to begin; to start; to commence / to happen (again); to begin (anew) / to date (from); to originate (in)
しぬ	shinu	死ぬ	to die; to pass away / to lose spirit; to lose vigor; to look dead / to cease; to stop
わかい	wakai	若い	young; youthful / immature; green / low (number); small
よわい	yowai	弱い	weak; frail; delicate; tender; unskilled; weak (wine)
ならう	narau	習う	to take lessons in; to be taught; to learn (from a teacher); to study (under a teacher); to get training in
すむ	sumu	住む	to live (of humans); to reside; to inhabit; to dwell; to abide
おもい	omoi	重い	heavy; weighty; massive / heavy (feeling); depressed; gloomy; blue; uneasy / slow; sluggish; lumbering; ponderous; clumsy / important; serious; grave / serious; severe; critical / solid; established; dignified; sensible
できる	dekiru	出来る	to be able (in a position) to do; to be up to the task / to be ready; to be completed / to be made; to be built / to be good at; to be permitted (to do) / to become intimate; to take up (with somebody) / to grow; to be raised / to become pregnant
はじめ	hajime	始め	beginning; start; outset; opening / first (in line, etc.) / origin / such as ...; not to mention ...
あつい	atsui	暑い	hot; warm; sultry; heated / passionate; impassioned; burning (desire, etc.) / on everybody's mind; on the radar; du jour; interested (gaze, etc.)
ちいさい	chiisai	小さい	small; little; tiny / slight; below average (in degree, amount, etc.); minor; small / low (e.g. sound); soft (e.g. voice) / unimportant; petty; insignificant; trifling; trivial / young; juvenile
すくない	sukunai	少ない	few; a little; scarce; insufficient; seldom
きえる	kieru	消える	to go out; to vanish; to disappear
けす	kesu	消す	to erase; to delete; to cross out / to turn off power / to extinguish; to put out / to bump off
のぼる	noboru	上る	to ascend; to go up; to climb / to ascend (as a natural process, e.g. the sun); to rise / to go to (the capital) / to be promoted / to add up to / to advance (in price) / to swim up (a river); to sail up / to come up (on the agenda)
のる	noru	乗る	to get on (train, plane, bus, ship, etc.); to get in; to board; to take; to embark / to get on (e.g. a footstool); to step on; to jump on; to sit on; to mount / to reach; to go over; to pass / to follow; to stay (on track); to go with (the times, etc.) / to take part; to participate; to join / to get into the swing (and sing, dance, etc.) / to be deceived; to be taken in / to be carried; to be spread; to be scattered / to stick; to attach; to take; to go on
たべる	taberu	食べる	to eat / to live on (e.g. a salary); to live off; to subsist on
ねる	neru	寝る	to lie down / to go to bed; to lie in bed / to sleep (lying down) / to sleep (with someone, i.e. have intercourse) / to lie idle
からい	karai	辛い	spicy; hot / salty / harsh (criticism); severe (punishment); strict / painful; bitter; difficult; tough
なる	naru	成る	to become; to get; to grow; to be; to reach; to attain / to result in; to prove to be / to consist of; to be composed of / to succeed; to be complete / to change into; to be exchanged for / to play a role / to be promoted / to do ...
はれ	hare	晴れ	clear weather; fine weather / formal; ceremonial; public / cleared of suspicion
はれる	hareru	晴れる	to clear up; to clear away; to be sunny; to stop raining / to refresh (e.g. spirits) / to be cleared (e.g. of a suspicion) / to be dispelled; to be banished
あおい	aoi	青い	blue; azure / green / pale; gray; grey / unripe; inexperienced
せっけん	sekken	石鹸	soap
あらう	arau	洗う	to wash; to cleanse; to rinse / to inquire into; to investigate / to purify (one's heart) / to lave (e.g. shore); to wash over (e.g. deck); to sweep
おおい	ooi	多い	many; numerous; a lot / large quantity; large amount / frequent; common
ふとい	futoi	太い	fat; thick / deep (of a voice); thick; sonorous / daring; shameless; brazen; audacious
まつ	matsu	待つ	to wait / to await; to look forward to; to anticipate / to depend on; to need
かす	kasu	貸す	to lend; to loan / to rent out; to hire out
たくさん	takusan	沢山	a lot; lots; plenty; many; a large number; much; a great deal; a good deal / enough; sufficient / enough; too many; too much
ぬぐ	nugu	脱ぐ	to take off (clothes, shoes, etc.); to undress
みじかい	mijikai	短い	short
おそい	osoi	遅い	slow; time-consuming; sluggish / late (in the day); towards the end (of the day or night); until a time far into the day or night / later (than expected or usual); late; behind schedule; behind time; tardy; overdue; unpunctual / too late; having missed the boat / dull; stupid
ちゃいろ	chairo	茶色	light brown; tawny
とぶ	tobu	飛ぶ	to fly; to soar / to jump; to leap; to spring; to bound; to hop
ながい	nagai	長い	long (distance) / long (time); lengthy
いたい	itai	痛い	painful; sore / cringy; embarrassing / exceeding
しめる	shimeru	締める	to tie; to fasten; to tighten / to wear (necktie, belt); to put on / to total; to sum / to be strict with / to economize; to economise; to cut down on / to salt; to marinate; to pickle; to make sushi adding a mixture of vinegar and salt
わたる	wataru	渡る	to cross over; to go across / to extend; to cover; to range; to span
おなじ	onaji	同じ	same; identical; equal; uniform; equivalent; similar; common (origin); changeless; alike / anyway; anyhow; in either case
ぶたにく	butaniku	豚肉	pork
くもる	kumoru	曇る	to get cloudy; to cloud over; to become overcast / to cloud up; to fog up; to mist up; to become dim / to be gloomy; to be clouded (expression); to be downcast / to look slightly downward (of a noh mask; indicating sadness, grief, etc.)
はいる	hairu	入る	to enter; to go into / to break into / to join; to enroll / to contain; to hold; to accommodate / to have (an income of) / to get; to receive; to score
しろい	shiroi	白い	white
うすい	usui	薄い	thin / pale; light; faint / watery; thin; dilute / weak (taste, etc.); little (affection, etc.) not much (of a presence) / slim (probability, etc.); small / sparse; patchy; scattered
はし	hashi	箸	chopsticks
やおや	yaoya	八百屋	greengrocer
あちら	achira	彼方	that way (direction distant from both speaker and listener); over there; yonder / that one (something physically distant from both speaker and listener, or something not visible but known by both speaker and listener); that / that person (someone physically distant from both speaker and listener, or someone not present but known by both speaker and listener) / there (place distant from both speaker and listener); over there; foreign country (esp. a Western nation)
つかれる	tsukareru	疲れる	to get tired; to tire / to be worn out (e.g. of well used objects) / to starve
ふろ	furo	風呂	bath; bathtub / bathroom; bathhouse / room for drying lacquerware / base (wooden joint connecting the blade of a hoe, spade, etc., to the handle)
ならぶ	narabu	並ぶ	to line up; to stand in a line / to rival; to match; to equal
しめる	shimeru	閉める	to close; to shut
いそがしい	isogashii	忙しい	busy; occupied; hectic / restless; hurried; fidgety
ほんだな	hondana	本棚	bookshelves; bookshelf; bookcase
まいばん	maiban	毎晩	every night
また	mata	又	again; and; also; still (doing something)
まんねんひつ	mannenhitsu	万年筆	fountain pen
おもしろい	omoshiroi	面白い	interesting; fascinating; intriguing; enthralling / amusing; funny; comical / pleasant; enjoyable; agreeable; fun
あそぶ	asobu	遊ぶ	to play; to enjoy oneself; to have a good time / to mess about (with alcohol, gambling, philandery, etc.) / to be idle; to do nothing; to be unused / to go to (for pleasure or for study) / to intentionally throw a ball to lower the batter's concentration
ゆうべ	yuube	夕べ	evening / last night; yesterday evening
ほしい	hoshii	欲しい	wanted; wished for; in need of; desired / I want (you) to
くる	kuru	来る	to come (spatially or temporally); to approach; to arrive / to come back; to do ... and come back / to come to be; to become; to get; to grow; to continue / to come from; to be caused by; to derive from / to come to (i.e. "when it comes to spinach ...")
すずしい	suzushii	涼しい	cool; refreshing / clear (e.g. eyes); bright / clear; distinct / composed (facial expression); unruffled; unconcerned / pure; upright; innocent
つめたい	tsumetai	冷たい	cold (to the touch); chilly; icy; freezing / coldhearted; unfeeling; indifferent; unfriendly
れい	rei	零	zero; nought
はなす	hanasu	話す	to talk; to speak; to converse; to chat / to tell; to explain; to narrate; to mention; to describe; to discuss / to speak (a language)
おととい	ototoi	一昨日	day before yesterday
なぜ	naze	何故	why; how
どこ	doko	何処	where; what place / how much (long, far); what extent
かわいい	kawaii	可愛い	cute; adorable; charming; lovely; pretty / dear; precious; darling; pet / innocent; childlike; childish; lovable / dainty; cute little; tiny
けさ	kesa	今朝	this morning
うわぎ	uwagi	上着	coat; tunic; jacket; outer garment
じょうぶ	joubu	丈夫	healthy; robust; strong; solid; durable
ゆうはん	yuuhan	夕飯	evening meal
あまり	amari	余り	remainder; remnant; rest; balance; surplus; remains (of a meal); leftovers / not very; not much / too much; excessively; overly / extreme; great; severe; tremendous; terrible / more than; over
あたたかい	atatakai	暖かい	warm; mild; (pleasantly) hot / considerate; kind; genial / warm (of a colour); mellow / having enough money
いろいろ	iroiro	色々	various; all sorts of; variety of / various colors (colours)
くもり	kumori	曇り	cloudiness; cloudy weather / fog (on a mirror, glasses, etc.); cloud (e.g. in marble); blur; mist; shadow; dimness / gloom; dejection
しょうゆ	shouyu	醤油	soy sauce; shoyu
たつ	tatsu	立つ	to stand; to rise; to stand up / to find oneself (e.g. in a difficult position) / to depart (on a plane, train, etc.)
たばこ	tabako	煙草	tobacco; cigarette; cigaret; cigar / tobacco plant (Nicotiana tabacum)
だんだん	dandan	段々	gradually; by degrees; little by little; more and more; increasingly / steps; stairs; staircase; terrace
のみもの	nomimono	飲み物	drink; beverage
まるい	marui	丸い	round; circular; spherical / harmonious; calm
め	me	目	eye; eyeball / eyesight; sight; vision / look; stare; glance / an experience / viewpoint / stitch; texture; weave / ordinal number suffix / somewhat; -ish
アパート	APAATO		apartment building; apartment block; apartment house / apartment
エレベーター	EREBEETAA		elevator; lift / elevator (aviation)
カップ	KAPPU		cup (drinking vessel, measure, brassiere, prize, etc.) / instant noodles purchased in cup; cup noodles
カメラ	KAMERA		camera
カレー	KAREE	咖哩	curry / rice and curry
カレンダー	KARENDAA		calendar / calender (machine for flattening things)
キロ	KIRO		kilo-; 1000 / kilogram; kilogramme / kilometre; kilometer / kilo-; 1024; 2^10
ギター	GITAA		guitar
クラス	KURASU		class
グラム	GURAMU	瓦	gram; gramme
コート	KOOTO		coat / court (i.e. tennis, basketball, etc.)
コーヒー	KOOHII	珈琲	coffee
コップ	KOPPU		glass (drinking vessel); tumbler / cop (police officer)
コピー	KOPII		copy; photocopy / blurb on a book jacket / catch copy
シャツ	SHATSU		shirt (underwear); undershirt; singlet / shirt (outerwear, esp. dress shirt)
シャワー	SHAWAA		shower
スカート	SUKAATO		skirt
ストーブ	SUTOOBU		(room) heater; stove
スプーン	SUPUUN		spoon
スポーツ	SUPOOTSU		sport; sports
スリッパ	SURIPPA		slipper; slippers
ズボン	ZUBON		trousers; pants
セーター	SEETAA		sweater; jumper
タクシー	TAKUSHII		taxi
テーブル	TEEBURU		table
テープ	TEEPU		tape
テープレコーダー	TEEPUREKOODAA		tape recorder
テスト	TESUTO		test
テレビ	TEREBI		television; TV / TV program; TV programme; TV broadcast
デパート	DEPAATO		department store / department
トイレ	TOIRE		toilet; restroom; bathroom; lavatory
ドア	DOA		door (Western-style)
ナイフ	NAIFU		knife
ニュース	NYUUSU		news
ネクタイ	NEKUTAI		tie; necktie
ノート	NOOTO		notebook; copy-book; exercise book / note; noting down / (musical) note / notebook computer; laptop
ハンカチ	HANKACHI		handkerchief
バス	BASU		bus / bath / bass
バター	BATAA		butter
パーティ	PAATEI		party
パン	PAN		bread; pastries (e.g. croissants); pastry-based products / pan; frying pan / panning (in a film)
フィルム	FYIRUMU		film
フォーク	FUOOKU		fork / folk; folk song / hawk
プール	PUURU		(swimming) pool / pool (billiards) / pool (together)
ベッド	BEDDO		bed
ページ	PEEJI	頁	page
ペン	PEN		pen
ホテル	HOTERU		hotel
ボールペン	BOORUPEN		ball-point pen
ボタン	BOTAN		button
ポケット	POKETTO		pocket
ポスト	POSUTO		postbox; mail box; pillar box / post; position / post (e.g. goalpost) / post- (e.g. post-Cold War)
マッチ	MATCHI	燐寸	match (to light fire with)
メートル	MEETORU	米	metre; meter / meter; gauge
ラジオ	RAJIO		radio
レコード	REKOODO		record (e.g. LP) / record (e.g. in sports) / record (data structure)
レストラン	RESUTORAN		restaurant (esp. Western-style)
ワイシャツ	WAISHATSU	Ｙシャツ	shirt; business shirt; dress shirt
ちょっと	chotto	一寸	a little; a bit; slightly / just a minute; for a moment; briefly / somewhat; rather; fairly; pretty; quite / (not) easily; (not) readily / hey!; excuse me
ほか	hoka	他	other (place, thing, person); the rest / outside; beyond / nothing except; nothing but; nothing apart from; nothing aside from; no choice (but to) / besides...; in addition to...
とおか	tooka	十日	the tenth day of the month / ten days
こたえる	kotaeru	答える	to answer; to reply
いる	iru	要る	to be needed; to be wanted
いちにち	ichinichi	一日	one day / first day of the month
あく	aku	開く	to open (e.g. doors) / to open (e.g. business, etc.) / to be empty / to be vacant; to be available; to be free / to be open (e.g. neckline, etc.) / to have been opened (of one's eyes, mouth, etc.) / to come to an end / to open (one's eyes, mouth, etc.) / to have a hole; to form a gap; to have an interval (between events)
あさごはん	asagohan	朝ご飯	breakfast
きく	kiku	聞く	to hear / to listen (e.g. to music) / to ask; to enquire; to query / to learn of; to hear about / to follow (advice); to comply with / to smell (esp. incense); to sample fragrance
きれい	kirei	奇麗	pretty; lovely; beautiful; fair / clean; clear; pure; tidy; neat / completely; entirely
ついたち	tsuitachi	一日	first day of the month / first ten days of the lunar month
あそこ	asoko	彼処	there (place physically distant from both speaker and listener); over there; that place; yonder; you-know-where / genitals; private parts / that far (something psychologically distant from both speaker and listener); that much; that point
あれ	are	彼	that (indicating something distant from both speaker and listener (in space, time or psychologically), or something understood without naming it directly) / that person (used to refer to one's equals or inferiors) / over there / down there (i.e. one's genitals) / period; menses / hey (expression of surprise, suspicion, etc.); huh?; eh? / that (something mentioned before which is distant psychologically or in terms of time)
ええ	ee		yes; that is correct; right / um; errr / huh? / grrr; gah; Must I? / good
おかし	okashi	お菓子	confections; sweets; candy
おにいさん	oniisan	お兄さん	older brother; elder brother / young man; buddy; fella; laddie
おねえさん	oneesan	お姉さん	elder sister / young lady / miss / ma'am / older girl
おてあらい	otearai	お手洗い	toilet; restroom; lavatory; bathroom
おじいさん	ojiisan	お祖父さん	grandfather / male senior-citizen
おばあさん	obaasan	お祖母さん	grandmother / old woman; female senior citizen
おなか	onaka	お腹	belly; abdomen; stomach
こちら	kochira	此方	this way (direction close to the speaker or towards the speaker); this direction / here (place close to the speaker or where the speaker is) / this one (something physically close to the speaker) / I; me; we; us / this person (someone physically close to the speaker and of equal or higher status)
こんな	konna		such (about something or someone close to the speaker (including the speaker), or about ideas expressed by the speaker); like this
さあ	saa		come; come now; come along; go on; hurry up / well; who knows; I don't know...; uh; hmm / well now; let's see; there we go; all right / about that; you see
じゃあ	jaa		then; well; so; well then / combination of 'de' and 'wa' particles / plain copula
そちら	sochira	其方	that way (direction distant from the speaker, close to the listener) / there (place distant from the speaker, close to the listener) / that one (something close to the listener) / you; your family; your company / that person (someone close to the listener)
それ	sore	其れ	that (indicating an item or person near the listener, the action of the listener, or something on their mind); it / that time; then / there (indicating a place near the listener) / you
それから	sorekara	其れから	and then; after that
つまらない	tsumaranai	詰らない	dull; uninteresting; boring; tedious / insignificant; unimportant; trifling; trivial; worthless / absurd; foolish; silly; stupid / useless; pointless; disappointing
では	deha		then; well; so; well then
とても	totemo	迚も	very; awfully; exceedingly / (not) at all; by no means; simply (cannot)
どう	dou	如何	how; in what way; how about
どうも	doumo		thank you; thanks / much (thanks); very (sorry); quite (regret) / quite; really; mostly / somehow / in spite of oneself; try as one might; no matter how hard one may try (to, not to) / greetings; hello; goodbye
どれ	dore	何れ	which (of three or more) / whichever; any / well; now; let me see
もう	mou		now; soon; shortly; before long; presently / already; yet; by now; (not) anymore / further; more; again; another; the other / tsk; dammit; jeez; come on
もっと	motto		(some) more; even more; longer; further
やる	yaru	遣る	to do; to undertake; to perform; to play (a game); to study / to send; to dispatch; to despatch / to put; to move; to turn (one's head, glance, etc.) / to give (esp. to someone of equal or lower status); to let have; to present; to bestow; to confer / to make (a vehicle) go faster / to run (a business); to keep; to be engaged in; to practice (law, medicine, etc.); to practise / to have (food, drink, etc.); to eat; to drink; to smoke / to hold (a performance); to perform; to show / to ease (one's mind) / to harm; to injure; to kill / to have sex with / to live; to get by; to get along / to do ... completely / to do ... broadly; to do ... to a great distance / to do ... for (someone of equal or lower status); to do ... to (sometimes with negative nuance) / to make active efforts to ...
ゆっくり	yukkuri		slowly; at ease; restful
より	yori		than / from; out of; since; at; on / except; but; other than / more
する	suru	為る	to do; to carry out; to perform / to cause to become; to make (into); to turn (into) / to serve as; to act as; to work as / to wear (clothes, a facial expression, etc.) / to judge as being; to view as being; to think of as; to treat as; to use as / to decide on; to choose / to be sensed (of a smell, noise, etc.) / to be (in a state, condition, etc.) / to be worth; to cost / to pass (of time); to elapse / to place, or raise, person A to a post or status B / to transform A to B; to make A into B; to exchange A for B / to make use of A for B; to view A as B; to handle A as if it were B / to feel A about B / verbalizing suffix (applies to nouns noted in this dictionary with the part of speech "vs") / creates a humble verb (after a noun prefixed with "o" or "go") / to be just about to; to be just starting to; to try to; to attempt to
ひく	hiku	引く	to pull; to tug; to lead (e.g. a horse) / to draw (attention, sympathy, etc.); to attract (e.g. interest) / to draw back (e.g. one's hand); to draw in (one's chin, stomach, etc.); to pull in / to draw (a card, mahjong tile, etc.) / to draw (a line, plan, etc.) / to catch (a cold) / to play (a stringed or keyboard instrument) / to look up (e.g. a dictionary); to consult / to haul; to pull (vehicles) / to subtract; to deduct / to recede; to ebb; to fade / to be descend from; to inherit (a characteristic) / to quote; to cite; to raise (as evidence) / to lay on (electricity, gas, etc.); to install (e.g. a telephone); to supply (e.g. water) / to hold (e.g. a note) / to apply (e.g. lipstick); to oil (e.g. a pan); to wax (e.g. a floor) / to move back; to draw back; to recede / to lessen; to subside; to ebb / to resign; to retire; to quit
おくさん	okusan	奥さん	wife; your wife; his wife; married lady; madam
ぬるい	nurui	温い	lukewarm; tepid / lenient / slow; stupid
した	shita	下	below; down; under; younger (e.g. daughter) / bottom / beneath; underneath / just after; right after / inferiority; one's inferior (i.e. one's junior) / trade-in / preliminary; preparatory
いつも	itsumo	何時も	always; usually; every time / never
どうぞ	douzo		please; kindly; I beg of you / by all means; feel free; you are welcome / here you are
どちら	dochira	何方	which way; which direction; where / which one (esp. of two alternatives) / who
どなた	donata	何方	who?
いえ	ie	家	house; residence; dwelling / family; household / lineage; family name
あける	akeru	開ける	to open (a door, etc.); to unwrap (e.g. parcel, package); to unlock / to open (for business, etc.) / to empty; to remove; to make space; to make room / to move out; to clear out / to be away from (e.g. one's house); to leave (temporarily) / to dawn; to grow light / to end (of a period, season) / to begin (of the New Year) / to leave (one's schedule) open; to make time (for) / to make (a hole); to open up (a hole)
かばん	kaban	鞄	bag; satchel; briefcase; basket
あなた	anata	貴方	you (referring to someone of equal or lower status) / dear (what a wife calls a husband)
ちかく	chikaku	近く	near; neighbourhood; neighborhood; vicinity / nearly (e.g. "it took nearly one year"); close to / shortly; soon
きんようび	kin'youbi	金曜日	Friday
ここのか	kokonoka	九日	the ninth day of the month / nine days
そら	sora	空	sky; the air; the heavens / weather / far-off place; distant place / state of mind; feeling / (from) memory; (by) heart / falsehood; lie / somehow; vaguely / fake
げつようび	getsuyoubi	月曜日	Monday
いつか	itsuka	五日	the fifth day of the month / five days
すき	suki	好き	liked; well-liked; favourite; favorite / in love (with); loved; romantically interested (in) / faddism; eccentricity / the way one likes; (as) it suits one
ここ	koko	此処	here (place physically close to the speaker, place pointed by the speaker while explaining); this place / these last (followed by a duration noun and a past sentence: time period before the present time of the speaker) / these next ... (followed by a duration noun and a non past sentence: time period after the present time of the speaker); the next ...
さく	saku	咲く	to bloom
みっか	mikka	三日	the third day of the month / three days
よっか	yokka	四日	fourth day of the month / four days
じびき	jibiki	字引	dictionary
つぎ	tsugi	次	next; following; subsequent / stage; station
はじめて	hajimete	初めて	for the first time / only after ... is it ...; only when ... do you ...
ところ	tokoro	所	place; spot; scene; site / address / district; area; locality / one's house / point; aspect; side; facet / passage (in text); part / space; room / thing; matter / whereupon; as a result / about to; on the verge of / was just doing; was in the process of doing; have just done; just finished doing
かく	kaku	書く	to write; to compose; to pen / to draw; to paint
うえ	ue	上	above; up; over; elder (e.g. daughter) / top; summit / surface; on / before; previous / superiority; one's superior (i.e. one's elder) / on top of that; besides; what's more / upon (further inspection, etc.); based on (and occurring after) / matters concerning...; as concerns ... / since (i.e. "for that reason") / suffix indicating higher social standing / place of one's superior (i.e. the throne) / emperor; sovereign; shogun; daimyo / noblewoman (esp. the wife of a nobleman)
ふく	fuku	吹く	to blow (e.g. wind); to play a wind instrument / to whistle / to laugh; to burst into laughter / to smelt; to mint / to brag; to talk big
すいようび	suiyoubi	水曜日	Wednesday
うまれる	umareru	生まれる	to be born
さき	saki	先	previous; prior; former; first; earlier; some time ago; preceding / point (e.g. pencil); tip; end; nozzle / head (of a line); front / ahead; the other side / the future; hereafter / destination / the other party
まえ	mae	前	ago; before (some event); previously; (minutes) to (the hour) / in front (of); before (e.g. the house) / head (of a line); front (e.g. of a bus); fore part / in the presence of / helping; portion / privates; private parts
それでは	soredeha	其れでは	well then ... / in that situation; in which case
たんじょうび	tanjoubi	誕生日	birthday
ひく	hiku	弾く	to play (a stringed or keyboard instrument)
おく	oku	置く	to put; to place / to leave (behind) / to establish (an organization, a facility, a position, etc.); to set up / to appoint (someone to a certain position); to hire; to employ / to place (one's trust, one's faith, etc); to bear (in mind etc) / to put down a tool (e.g. a pen) hence stopping what one is doing with that tool / to take in (boarders, etc.); to provide lodging in one's house / to separate spatially or temporally / to do something in advance / to leave something in a certain state; to keep something in a certain state
つく	tsuku	着く	to arrive at; to reach / to sit on; to sit at (e.g. the table)
なか	naka	中	inside; in / among; within / center (centre); middle / during; while
ちょうど	choudo	丁度	exactly; precisely; just; right / as if; as though; quite
どようび	doyoubi	土曜日	Saturday
はたらく	hataraku	働く	to work; to labor; to labour / to function; to operate; to be effective; to work (i.e. ... works); to come into play / to commit (e.g. a crime); to perpetrate; to do; to act; to practise; to practice / to be conjugated
ふつか	futsuka	二日	second day of the month / two days
にぎやか	nigiyaka	賑やか	bustling; busy; lively
にちようび	nichiyoubi	日曜日	Sunday
いれる	ireru	入れる	to put in; to let in; to take in; to bring in; to insert; to set (a jewel, etc.); to ink in (e.g. a tattoo) / to admit; to accept; to employ; to hire / to accept; to comply; to grant; to adopt (a policy, etc.); to take (advice, etc.); to listen to; to pay attention to / to include / to pay (one's rent, etc.) / to cast (a vote) / to make (tea, coffee, etc.) / to turn on (a switch, etc.) / to send (a fax); to call
どうして	doushite	如何して	why?; for what reason; how; in what way; for what purpose; what for
ようか	youka	八日	the eighth day of the month / eight days
うるさい	urusai	煩い	noisy; loud / annoying; troublesome; tiresome; persistent; importunate / fussy; finicky; picky; particular; nagging; fastidious; bossy / shut up!; be quiet!
おいしい	oishii	美味しい	delicious; tasty; sweet / attractive; appealing; convenient; favorable; desirable; profitable
まずい	mazui	不味い	unappetising; unappetizing; unsavoury; unsavory; unpleasant / unskillful; unskilful; bungling; clumsy; poor / ugly; unattractive; homely; plain / awkward; problematic; troublesome; unfavorable; unfavourable; unwise
かぜ	kaze	風	wind; breeze; draught; draft / manner; behaviour; behavior / cold; influenza
もの	mono	物	thing; object; article; stuff; substance / one's things; possessions; property; belongings / things; something; anything; everything; nothing / quality / reason; the way of things / used to emphasize emotion, judgment, etc.; used to indicate a common occurrence in the past (after a verb in past tense); used to indicate a general tendency; used to indicate something that should happen / item classified as ...; item related to ...; work of ... / cause of ...; cause for ... / somehow; somewhat; for some reason / really; truly
しかし	shikashi	然し	however; but
ならべる	naraberu	並べる	to line up; to set up; to arrange in a line / to enumerate; to itemize / to be equal (to); to compare well (with); to be as good (as)
あるく	aruku	歩く	to walk
かた	kata	方	direction; way / person; lady; gentleman / method of; manner of; way of / care of ... / person in charge of ... / side (e.g. "on my mother's side")
わすれる	wasureru	忘れる	to forget; to leave carelessly; to be forgetful of; to forget about; to forget (an article)
ほん	hon	本	book; volume; script / this; present / main; head / real; regular / counter for long cylindrical things; counter for films, TV shows, etc.; counter for goals, home runs, etc.; counter for telephone calls
みがく	migaku	磨く	to polish; to shine; to brush (e.g. teeth); to grind (e.g. lens) / to refine (e.g. a skill); to improve; to cultivate
まだ	mada	未だ	as yet; hitherto; only; still / not yet / more; besides / unfinished; incomplete; not yet finished with
なくす	nakusu	無くす	to lose (something); to mislay / to get rid of; to eliminate; to remove
なく	naku	鳴く	to sing (bird) / to make sound (animal); to call; to cry; to chirp / to make a meld call (e.g. pung, kong)
もくようび	mokuyoubi	木曜日	Thursday
はがき	hagaki	葉書	postcard / memo; note; card
むいか	muika	六日	sixth day of the month / six days
いる	iru	居る	to be (of animate objects); to exist / to stay / to be ...-ing; to have been ...-ing
いく	iku	行く	to go; to move (in a direction or towards a specific location); to head (towards); to be transported (towards); to reach / to proceed; to take place / to pass through; to come and go / to walk / to die; to pass away / to do (in a specific way) / to stream; to flow / to continue / to have an orgasm; to come; to cum / to trip; to get high; to have a drug-induced hallucination
なのか	nanoka	七日	the seventh day of the month / seven days
まっすぐ	massugu	真っ直ぐ	straight (ahead); direct; upright; erect / straightforward; honest; frank
ひと	hito	人	man; person / human being; mankind; people / human (Homo sapiens); humans as a species / character; personality / man of talent; true man / another person; other people; others / adult
みせ	mise	店	store; shop; establishment; restaurant
あたま	atama	頭	head / hair (on one's head) / mind; brains; intellect / leader; chief; boss; captain / top; tip / beginning; start / head; person / top structural component of a kanji / pair
この	kono	此の	this (something or someone close to the speaker (including the speaker), or ideas expressed by the speaker)
やっつ	yattsu	八つ	eight
まん	man	万	10,000; ten thousand / myriad / everything; all / various
あさって	asatte	明後日	day after tomorrow
むっつ	muttsu	六つ	six
はたち	hatachi	二十歳	20 years old / twenty
はつか	hatsuka	二十日	twentieth day of the month / twenty days
よく	yoku	良く	nicely; properly; well; skillfully; skilfully / frequently; often
はく	haku	履く	to put on (or wear) lower-body clothing (i.e. pants, skirt, etc.); to put on (or wear) footwear / to affix a sword to one's hip / to affix a bowstring to a bow
つける	tsukeru	点ける	to turn on; to switch on; to light up
そうして	soushite	然うして	and; like that
これ	kore	此れ	this (indicating an item near the speaker, the action of the speaker, or the current topic) / this person (usu. indicating someone in one's in-group) / now / here / I (me) / certainly
いい	ii		good; excellent; fine; nice; pleasant; agreeable / sufficient (can be used to turn down an offer); ready; prepared / profitable (e.g. deal, business offer, etc.); beneficial / OK
あの	ano	彼の	that (someone or something distant from both speaker and listener, or situation unfamiliar to both speaker and listener)
あのう	anou		say; well; errr ...
そこ	soko	其処	there (place relatively near listener) / there (place just mentioned); that place / then (of some incident just spoken of); that (of point just raised) / you
その	sono	其の	that (something or someone distant from the speaker, close to the listener; actions of the listener, or ideas expressed or understood by the listener); the / um...; er...; uh...
でも	demo		but; however; though; nevertheless; still; yet; even so; also; as well / even / however; no matter how; even if; even though / ... or something / either ... or ...; neither ... nor ... / pseudo-; quack; in-name-only / for lack of anything better to do
はい	hai		yes; that is correct / understood; I see; OK; okay / present; here / pardon?; what's that?; come again? / now; here; here you go / giddy-up; giddap
ひとつき	hitotsuki	一月	one month
けいにく	keiniku	鶏肉	chicken meat
すぐに	suguni	直ぐに	immediately; right away; at once; instantly
おべんとう	obentou	お弁当	bento; Japanese box lunch
など	nado	等	et cetera; etc.; and the like; and so forth / or something / the likes of
ばんごはん	bangohan	晩御飯	dinner; evening meal
もういちど	mouichido	もう一度	once more; again
あか	aka	赤	red; crimson; scarlet / red-containing colour (e.g. brown, pink, orange) / Red (i.e. communist) / red light (traffic) / red ink (i.e. in finance or proof-reading); (in) the red / complete; total; perfect; obvious / copper
ちいさな	chiisana	小さな	small; little; tiny
せ	se	背	back; spine / reverse; rear side / height; stature / ridge (of a mountain)
ペット	PETTO		pet / trumpet
ラジカセ	RAJIKASE		radio-cassette player
おさら	osara	お皿	plate; dish
おさけ	osake	お酒	alcohol; sake
ひるごはん	hirugohan	昼ご飯	lunch; midday meal
おふろ	ofuro	お風呂	bath
おじさん	ojisan	伯父さん	uncle / old man; mister / manybar goatfish (Parupeneus multifasciatus)
おばさん	obasan	伯母さん	aunt
こども	kodomo	子供	child
しち	shichi	七	seven / hepta-
あし	ashi	足	foot / leg / gait / pace / bottom structural component (i.e. radical) of a kanji / means of transportation / money; coin
いう	iu	言う	to say; to utter; to declare / to name; to call / to go (e.g. "the alarm went ping"); to make a noise
いみ	imi	意味	meaning; significance; sense
ひとつ	hitotsu	一つ	one / for one thing / only / (not) even / just (e.g. "just try it")
いちばん	ichiban	一番	number one; first; first place / best; most / game; round; bout / as a test; as an experiment; by way of experiment; by way of trial; tentatively / song (e.g. in noh); piece
みぎ	migi	右	right; right hand side / afore-mentioned (esp. in vertical Japanese writing); foregoing; forgoing; above
えいが	eiga	映画	movie; film
おんがく	ongaku	音楽	music
なつ	natsu	夏	summer
かぞく	kazoku	家族	family; members of a family
かてい	katei	家庭	home; family; household
うた	uta	歌	song / classical Japanese poetry (esp. tanka) / modern poetry
はな	hana	花	flower; blossom; bloom; petal / cherry blossom / beauty / blooming (esp. of cherry blossoms) / ikebana / hanafuda / (the) best / glorious; lovely
かいしゃ	kaisha	会社	company; corporation / workplace
がいこく	gaikoku	外国	foreign country
がいこくじん	gaikokujin	外国人	foreigner; foreign citizen; foreign national; alien; non-Japanese
がっこう	gakkou	学校	school
がくせい	gakusei	学生	student (esp. a university student)
ぎんこう	ginkou	銀行	bank
ことば	kotoba	言葉	language; dialect / word; words; phrase; term; expression; remark / speech; (manner of) speaking / learning to speak; language acquisition
ご	go	五	five
ごご	gogo	午後	afternoon; p.m.
ごぜん	gozen	午前	morning; a.m.
あと	ato	後	behind; rear / after; later / after one's death / remainder; the rest / descendant; successor; heir / more (e.g. five more minutes); left / also; in addition / past; previous
こんげつ	kongetsu	今月	this month
ひだり	hidari	左	left; left hand side
しごと	shigoto	仕事	work; job; business; occupation; employment; vocation; task / work
わたし	watashi	私	I; me / private affairs; personal matter; secrecy / selfishness
じかん	jikan	時間	time / hour
じどうしゃ	jidousha	自動車	automobile
じぶん	jibun	自分	myself; yourself; oneself; himself; herself / I; me / you
しつもん	shitsumon	質問	question; inquiry; enquiry
しゃしん	shashin	写真	photograph; photo; picture; snapshot; snap / movie
くるま	kuruma	車	car; automobile; vehicle / wheel
て	te	手	hand; arm / forepaw; foreleg / handle / hand; worker; help / trouble; care; effort / means; way; trick; move; technique; workmanship / hand; handwriting / kind; type; sort / one's hands; one's possession / ability to cope / hand (of cards) / direction / move (in go, shogi, etc.)
あき	aki	秋	autumn; fall
はる	haru	春	spring; springtime / New Year / prime (of one's life, etc.) / adolescence; puberty / sexuality
すこし	sukoshi	少し	small quantity; little; few; something / little while / short distance
あげる	ageru	上げる	to raise; to elevate / to do up (one's hair) / to fly (a kite, etc.); to launch (fireworks, etc.); to surface (a submarine, etc.) / to land (a boat) / to deep-fry / to show someone (into a room) / to summon (for geishas, etc.) / to send someone (away) / to enrol (one's child in school); to enroll / to increase (price, quality, status, etc.); to develop (talent, skill); to improve / to make (a loud sound); to raise (one's voice) / to earn (something desirable) / to praise / to give (an example, etc.); to cite / to summon up (all of one's energy, etc.) / to arrest / to nominate / to give / to offer up (incense, a prayer, etc.) to the gods (or Buddha, etc.) / to bear (a child) / to conduct (a ceremony, esp. a wedding) / (of the tide) to come in / to vomit / to do for (the sake of someone else) / to complete ... / to humbly do ...
しんぶん	shinbun	新聞	newspaper
みず	mizu	水	water (esp. cool, fresh water, e.g. drinking water) / fluid (esp. in an animal tissue); liquid / flood; floodwaters / water offered to wrestlers just prior to a bout / break granted to wrestlers engaged in a prolonged bout
こえ	koe	声	voice / singing (of a bird); chirping (of an insect); hoot / voice; opinion (as expressed in words); view; wish; attitude; will / sound / sense (of something's arrival); feeling / voice; voiced sound
せん	sen	千	1,000; thousand
だいがく	daigaku	大学	university; college / former central university of Kyoto (established under the ritsuryo system for the training of government administrators) / the Great Learning (one of the Four Books)
おとこ	otoko	男	man; male / fellow; guy; chap; bloke / male lover; boyfriend; man / manliness; manly honor; manly honour; manly reputation
でんわ	denwa	電話	telephone call; phone call / telephone (device); phone
ひがし	higashi	東	east
みち	michi	道	road; path; street; lane; passage / route; way / distance; journey / road (e.g. to victory); course / way (of living, proper conduct, etc.); moral principles / teachings (esp. Confucian or Buddhist); dogma / field (e.g. of medicine); subject; speciality / means; way; method
みなみ	minami	南	south
に	ni	二	two
ひゃく	hyaku	百	100; hundred
びょういん	byouin	病院	hospital
きた	kita	北	north / the North; northern territories / North Korea / north wind
まいにち	mainichi	毎日	every day
き	ki	木	tree; shrub; bush / wood; timber
もんだい	mondai	問題	question (e.g. on a test); problem / problem (e.g. societal, political); question; issue; subject (e.g. of research); case; matter / question (i.e. doubt) / public discussion; controversy / trouble; problem; inconvenience; difficulty
らいねん	rainen	来年	next year
ひとり	hitori	一人	one person / alone; unmarried; solitary
きゅう	kyuu	九	nine
ことし	kotoshi	今年	this year
さん	san	三	three / tri-
よん	yon	四	four
じゅう	juu	十	ten
ふたり	futari	二人	two persons; two people; pair; couple
はち	hachi	八	eight
ろく	roku	六	six
くに	kuni	国	country; state / region / national government; central government / home (i.e. hometown, home country) / province (of Japan) / land; earth
はなし	hanashi	話	talk; speech; chat; story; conversation / discussions; negotiation; argument
いっしょ	issho	一緒	together / at the same time / same; identical
あめ	ame	雨	rain
えいご	eigo	英語	English (language)
うみ	umi	海	sea; ocean; waters
そと	soto	外	outside; exterior / open air / other place
けっこん	kekkon	結婚	marriage
よぶ	yobu	呼ぶ	to call out (to); to call; to invoke / to summon (a doctor, etc.) / to invite / to designate; to name; to brand / to garner (support, etc.); to gather / to take as one's wife
こうえん	kouen	公園	(public) park
くち	kuchi	口	mouth / opening; hole; gap; orifice / mouth (of a bottle); spout; nozzle; mouthpiece / gate; door; entrance; exit / speaking; speech; talk (i.e. gossip) / taste; palate / mouth (to feed) / opening (i.e. vacancy); available position / invitation; summons / kind; sort; type / opening (i.e. beginning) / counter for mouthfuls, shares (of money), and swords
ざっし	zasshi	雑誌	journal; magazine; periodical
やま	yama	山	mountain; hill / mine (e.g. coal mine) / heap; pile / crown (of a hat); thread (of a screw); tread (of a tire); protruding part of an object / climax; peak; critical point / guess; speculation / criminal case; crime / mountain climbing; mountaineering / festival float (esp. one mounted with a decorative halberd) / wall; wall tile / temple; temple grounds / wild
つかう	tsukau	使う	to use (a thing, method, etc.); to make use of; to put to use / to use (a person, animal, puppet, etc.); to employ; to handle; to manage; to manipulate / to use (time, money, etc.); to spend; to consume / to use (language); to speak
おんな	onna	女	female; woman; female sex / female lover; girlfriend; mistress; (someone's) woman
いろ	iro	色	colour; color; hue; tint; tinge; shade / complexion; skin colour; skin color / look (on one's face); expression / appearance; air; feeling / personality; character / tone (of one's voice, etc.); tune; sound; ring / love; lust; sensuality; love affair / lover; paramour / beauty; sexiness; physical appeal / kind; type; variety
せいと	seito	生徒	pupil; student; schoolchild
にし	nishi	西	west
せんげつ	sengetsu	先月	last month
せんせい	sensei	先生	teacher; master; doctor / with names of teachers, etc. as an honorific / previous existence
かわ	kawa	川	river; stream / River; the ... river
からだ	karada	体	body / torso; trunk / build; physique; constitution / health / corpse; dead body
たいせつ	taisetsu	大切	important; necessary; indispensable / beloved; precious; dear; cherished; valuable / careful
たいへん	taihen	大変	very; greatly; terribly; awfully / immense; enormous; great / serious; grave; dreadful; terrible / difficult; hard / major incident; disaster
しる	shiru	知る	to be aware of; to know; to be conscious of; to cognize; to cognise / to notice; to feel / to understand; to comprehend; to grasp / to remember; to be acquainted with (a procedure) / to experience; to go through; to learn / to be acquainted with (a person); to get to know / to concern
でんき	denki	電気	electricity / (electric) light
どうぶつ	doubutsu	動物	animal
ふたつ	futatsu	二つ	two
とし	toshi	年	year / age; years / past one's prime; old age
はんぶん	hanbun	半分	half
びょうき	byouki	病気	illness; disease; sickness
へや	heya	部屋	room; chamber / apartment; flat; pad / stable
ほんとう	hontou	本当	truth; reality; actuality; fact / proper; right; correct; official / genuine; authentic; natural; veritable
なまえ	namae	名前	name; full name / given name; first name
よる	yoru	夜	evening; night
りょこう	ryokou	旅行	travel; trip; journey; excursion; tour
りょうり	ryouri	料理	cooking; cookery; cuisine / dealing with something; handling; administration; management
れんしゅう	renshuu	練習	practice; practising
いっさくねん	issakunen	一昨年	year before last
なに	nani	何	what / how many / large number of; many / you-know-what; that / whatsit; what's the expression; what do you call them / what? / hey!
さかな	sakana	魚	fish
こんにち	konnichi	今日	today; this day / these days; recently; nowadays
まち	machi	町	town; block; neighbourhood; neighborhood / street; road / 109.09 m / 0.99 hectares / downtown; main street
よこ	yoko	横	horizontal (as opposed to vertical); lying down / side-to-side (as opposed to front-to-back); width; breadth / side (of a box, etc.) / beside; aside; next to / unconnected
え	e	絵	picture; drawing; painting; sketch
きょうしつ	kyoushitsu	教室	classroom / department; laboratory / single-room school; small school
たてもの	tatemono	建物	building
いぬ	inu	犬	dog (Canis (lupus) familiaris) / snoop (i.e. a detective, a spy, etc.) / loser; asshole / counterfeit; inferior; useless; wasteful
くろ	kuro	黒	black / black go stone / guilt; guilty person
ある	aru	在る	to be; to exist; to live / to have / to be located / to be equipped with / to happen; to come about
みっつ	mittsu	三つ	three
かみ	kami	紙	paper
みみ	mimi	耳	ear / hearing / edge; crust / selvedge (non-fray machined edge of fabrics); selvage
てがみ	tegami	手紙	letter
じゅぎょう	jugyou	授業	lesson; class work; teaching; instruction
だす	dasu	出す	to take out; to get out / to put out; to reveal; to show / to submit (e.g. thesis); to turn in / to publish; to make public / to send (e.g. letter) / to produce (a sound); to start (fire) / to serve (food) / to begin ...; to start to ...; to burst into ...
あお	ao	青	blue; azure / green / green light (traffic) / black (horse coat color) / immature; unripe; young
ゆき	yuki	雪	snow
ぜんぶ	zenbu	全部	all; entire; whole; altogether
そば	soba	側	near; close; beside; vicinity; proximity; besides; while / third person
むら	mura	村	village
たいしかん	taishikan	大使館	embassy
おとな	otona	大人	adult
ふゆ	fuyu	冬	winter
しろ	shiro	白	white / innocence; innocent person / blank space / white go stone / white dragon tile / skewered grilled pig intestine
はん	han	半	half; semi- / half-past / odd number / unit of land area (595.8 m^2)
ばんごう	bangou	番号	number; series of digits
べんきょう	benkyou	勉強	study / diligence / discount; reduction
やさい	yasai	野菜	vegetable
ゆうめい	yuumei	有名	famous / fame
らいげつ	raigetsu	来月	next month
みどり	midori	緑	green / greenery (esp. fresh verdure)
まいとし	maitoshi	毎年	every year; yearly; annually
もん	mon	門	gate / branch of learning based on the teachings of a single master / division; phylum / counter for cannons
つくる	tsukuru	作る	to make; to produce; to manufacture; to build; to construct / to prepare (food); to brew (alcohol) / to raise; to grow; to cultivate; to train / to till / to draw up (a document); to make out; to prepare; to write / to create (an artistic work, etc.); to compose / to coin (a phrase); to organize; to organise; to establish; to found / to have (a child) / to make up (one's face, etc.) / to fabricate (an excuse, etc.) / to give a (false) appearance; to feign (a smile, etc.); to put on a show of emotion / to form (a line, etc.) / to set (a record) / to commit (a sin, etc.)
りょうしん	ryoushin	両親	parents; both parents
おかね	okane	お金	money
ひろい	hiroi	広い	spacious; vast; wide
じてんしゃ	jitensha	自転車	bicycle
まど	mado	窓	window
おおぜい	oozei	大勢	crowd of people; great number of people / in great numbers
ひる	hiru	昼	noon; midday / daytime / lunch
とり	tori	鳥	bird / bird meat (esp. chicken meat); fowl; poultry
でんしゃ	densha	電車	train; electric train
ふく	fuku	服	clothes (esp. Western clothes) / counter for doses of medicine, gulps of tea, drags of a cigarette, etc.
くすり	kusuri	薬	medicine; pharmaceuticals; (legal) drugs; pill; ointment; salve / efficacious chemical (gunpowder, pesticide, etc.) / (pottery) glaze / small bribe
ともだち	tomodachi	友達	friend; companion
となり	tonari	隣	neighbor (neighbour); next to (esp. living next door to)
おとうと	otouto	弟	younger brother; little brother; kid brother / pupil; apprentice
おかあさん	okaasan	お母さん	mother; mom; mum; ma / wife
えき	eki	駅	railway station; train station / staging post on a highway (in pre-modern Japan)
なつやすみ	natsuyasumi	夏休み	summer vacation; summer holiday
みんな	minna	皆	all; everyone; everybody / everything
やすみ	yasumi	休み	rest; recess; respite / vacation; holiday; absence; suspension / dormancy (of a silkworm prior to moulting)
はし	hashi	橋	bridge
あに	ani	兄	elder brother; older brother
きょうだい	kyoudai	兄弟	siblings; brothers and sisters / brothers / siblings-in-law; brothers-in-law; sisters-in-law / mate; friend
けいかん	keikan	警官	police officer; policeman; constable
げんかん	genkan	玄関	entrance; front door; entryway; entranceway; entry hall; vestibule; porch; foyer; mud room
こんしゅう	konshuu	今週	this week
は	ha	歯	tooth
としょかん	toshokan	図書館	library
しずか	shizuka	静か	quiet; silent / slow; unhurried / calm; peaceful
せんしゅう	senshuu	先週	last week; the week before
おおきな	ookina	大きな	big; large; great
ちかてつ	chikatetsu	地下鉄	underground train; subway
ちず	chizu	地図	map
いけ	ike	池	pond
にく	niku	肉	flesh / meat / the physical body (as opposed to the spirit) / thickness / ink pad
ひこうき	hikouki	飛行機	aeroplane; airplane; aircraft
ぶんしょう	bunshou	文章	writing; composition; essay; article; prose; (writing) style / sentence
まいしゅう	maishuu	毎週	every week
たまご	tamago	卵	eggs; egg; spawn; roe / hen egg / (an expert) in the making / beginning; origin; infancy
りゅうがくせい	ryuugakusei	留学生	overseas student; exchange student
いりぐち	iriguchi	入口	entrance; entry; gate; approach; mouth
まいげつ	maigetsu	毎月	every month; each month; monthly
みょうにち	myounichi	明日	tomorrow / near future
おちゃ	ocha	お茶	tea (usu. green) / tea break (at work) / tea ceremony
いしゃ	isha	医者	(medical) doctor; physician
みなさん	minasan	皆さん	all; everyone; everybody
かど	kado	角	corner (e.g. desk, pavement) / edge
つとめる	tsutomeru	勤める	to work (for); to be employed (at); to serve (in) / to serve (as); to act (as); to fill (the position of); to play the role (of) / to conduct a religious service
くつ	kutsu	靴	shoes; boots; footwear; footgear
げんき	genki	元気	lively; full of spirit; energetic; vigorous; vital; spirited / healthy; well; fit; in good health
うしろ	ushiro	後ろ	back; behind; rear
よっつ	yottsu	四つ	four / four years of age / ten o'clock (old time system) / cross grips
とる	toru	取る	to take; to pick up; to harvest; to earn; to win; to choose / to steal / to eat; to have (a meal) / to remove (one's glasses, etc.) / to compete (in sumo, cards, etc.); to play
おんなのこ	onnanoko	女の子	girl; daughter / young woman
だいじょうぶ	daijoubu	大丈夫	safe; secure; sound; problem-free; without fear; all right; alright; OK; okay / certainly; surely; undoubtedly / no thanks; I'm good; that's alright / great man; fine figure of a man
にわ	niwa	庭	garden; yard; courtyard / field (of action); area
てんき	tenki	天気	weather; the elements / fair weather; fine weather
べんり	benri	便利	convenient; handy; useful
いもうと	imouto	妹	younger sister
らいしゅう	raishuu	来週	next week
りっぱ	rippa	立派	splendid; fine; handsome; elegant; imposing; prominent / praiseworthy; creditable; worthy / legal; legitimate; lawful / undeniable (e.g. crime); indisputable; solid
しお	shio	塩	salt (i.e. sodium chloride); common salt; table salt / salt (e.g. sodium chloride, calcium sulfate, etc.) / hardship; toil; trouble / saltiness
かいもの	kaimono	買い物	shopping; purchased goods
どの	dono	何の	which; what (way)
おとうさん	otousan	お父さん	father; dad; papa; pa; pop; daddy; dada / husband
かいだん	kaidan	階段	stairs; stairway; staircase
かんじ	kanji	漢字	Chinese characters; kanji
つくえ	tsukue	机	desk
と	to	戸	door (esp. Japanese-style) / shutter; window shutter / entrance (to a home) / narrows
いま	ima	今	now; the present time; just now; soon; immediately; (one) more
あね	ane	姉	older sister; elder sister
とけい	tokei	時計	watch; clock; timepiece
だいどころ	daidokoro	台所	kitchen / financial situation
おとこのこ	otokonoko	男の子	boy; male child; baby boy
むずかしい	muzukashii	難しい	difficult; hard; troublesome; complicated; serious (disease, problem, etc.) / fussy; particular; fastidious; hard to please; displeased / gloomy; glum; sullen; serious (look) / dirty; unclean; filthy; detestable / unpleasant; uncomfortable; creepy; spooky
ねこ	neko	猫	cat / shamisen / geisha / wheelbarrow / clay bed-warmer / bottom; submissive partner of a homosexual relationship
ばん	ban	晩	evening / counter for nights
ゆうびんきょく	yuubinkyoku	郵便局	post office
ゆうがた	yuugata	夕方	evening; dusk
いや	iya	嫌	disagreeable; detestable; unpleasant; reluctant
おおきい	ookii	大きい	big; large; great / loud / extensive; spacious / important; decisive; valuable / older; grown up
ときどき	tokidoki	時々	sometimes; at times
おす	osu	押す	to push; to press / to apply pressure from above; to press down / to stamp (i.e. a passport); to apply a seal / to affix (e.g. gold leaf) / to press (someone for something); to urge; to compel; to influence / to overwhelm; to overpower; to repress / to push (events along); to advance (a plan) / to do in spite of ...; to do even though ...; to force / to make sure / to be pressed for time / to advance troops; to attack / (of light) to be diffused across an entire surface
ぎゅうにく	gyuuniku	牛肉	beef
ぎゅうにゅう	gyuunyuu	牛乳	(cow's) milk
けっこう	kekkou	結構	splendid; nice; wonderful; delicious; sweet / sufficient; fine (in the sense of "I'm fine"); (by implication) no thank you / well enough; OK; tolerable / quite; reasonably; fairly; tolerably / construction; architecture
きらい	kirai	嫌い	disliked; hated; disagreeable / tendency; smack (of); touch (of) / distinction; discrimination
たかい	takai	高い	high; tall / expensive; high-priced / high (level); above average (in degree, quality, etc.) / loud / high-pitched; shrill
さとう	satou	砂糖	sugar
もつ	motsu	持つ	to hold (in one's hand); to take; to carry / to possess; to have; to own / to maintain; to keep / to last; to be durable; to keep; to survive / to take charge of; to be in charge of
たて	tate	縦	the vertical; height / front-to-back; length / north-to-south / vertical (relationship); hierarchy / (weaving) warp
でぐち	deguchi	出口	exit; gateway; way out; outlet; leak; vent
たべもの	tabemono	食べ物	food
しょくどう	shokudou	食堂	dining room; dining hall; cafeteria; messroom / restaurant; eatery; snack bar; diner
あたらしい	atarashii	新しい	new; novel; fresh; recent; latest; up-to-date; modern
きって	kitte	切手	stamp (postage); merchandise certificate
だいすき	daisuki	大好き	loveable; very likeable; like very much
うる	uru	売る	to sell
はな	hana	鼻	nose
たのむ	tanomu	頼む	to request; to beg; to ask / to call; to order; to reserve / to entrust to / to rely on
れいぞうこ	reizouko	冷蔵庫	refrigerator
えいがかん	eigakan	映画館	movie theatre; movie theater; cinema
くだもの	kudamono	果物	fruit
にもつ	nimotsu	荷物	luggage; baggage; package / burden / payload (of a packet, cell, etc.)
いつつ	itsutsu	五つ	five
さくぶん	sakubun	作文	writing (an essay, prose, etc.); composition / formal writing with little real meaning
せんたく	sentaku	洗濯	washing; laundry / relaxing; taking a break
そうじ	souji	掃除	cleaning; sweeping; dusting; scrubbing
あさ	asa	朝	morning
ぼうし	boushi	帽子	hat; cap
あかるい	akarui	明るい	light; well-lit; well-lighted / bright (of a colour); brightly-coloured; brightly-colored / cheerful; bright; spirited; sunny (e.g. disposition) / encouraging (for the future of a project, etc.); promising; of fair prospects / familiar (with); knowledgeable (about); well versed (in) / fair (e.g. politics); clean; impartial
あびる	abiru	浴びる	to dash over oneself (e.g. water); to take (e.g. shower); to bask in (e.g. the sun); to bathe in; to be flooded with (e.g. light); to be covered in / to suffer (e.g. an attack); to draw (e.g. criticism, attention, praise); to have heaped upon; to be showered with
かぜ	kaze	風邪	common cold; cold; influenza; flu; ague
はこ	hako	箱	box; case; chest; package; pack; crate / car (of a train, etc.) / shamisen case; shamisen / public building; community building / man who carries a geisha's shamisen / receptacle for human waste; feces (faeces) / counter for boxes (or boxed objects)
きっさてん	kissaten	喫茶店	coffee shop; tearoom; coffee lounge; coffeehouse; cafe
きょねん	kyonen	去年	last year
さいふ	saifu	財布	purse; handbag; wallet
さんぽ	sanpo	散歩	walk; stroll
じしょ	jisho	辞書	dictionary; lexicon / letter of resignation
きっぷ	kippu	切符	ticket
はしる	hashiru	走る	to run / to travel (movement of vehicles); to drive; to flow (e.g. energy) / to hurry to / to retreat (from battle); to take flight / to run away from home / to elope / to tend heavily toward / to flash; to streak; to shoot through (e.g. pain)
かう	kau	買う	to buy; to purchase / to value; to have a high opinion / to stir; to provoke; to draw upon oneself
へん	hen	辺	area; vicinity; region / side; edge / circumstances
ろうか	rouka	廊下	corridor; hallway; passageway
さくじつ	sakujitsu	昨日	yesterday
いいえ	iie	否	no; nay / well; er; why / you're welcome; not at all; don't mention it
おりる	oriru	降りる	to descend (e.g. a mountain); to go down; to come down / to alight (e.g. from bus); to get off; to disembark; to dismount / to step down; to retire; to give up; to quit / to be granted; to be issued; to be given / to form (of frost, dew, mist, etc.) / to be passed (from the body; e.g. of a roundworm)
かさ	kasa	傘	umbrella; parasol / something shaped like an umbrella or a conical hat; shade (of a lamp); mushroom cap; pileus
きる	kiru	切る	to cut; to cut through; to perform (surgery) / to sever (connections, ties) / to turn off (e.g. the light) / to terminate (e.g. a conversation); to hang up (the phone); to disconnect / to punch (a ticket); to tear off (a stub) / to open (something sealed) / to start / to set (a limit); to do (something) in less or within a certain time; to issue (stamps, vouchers, etc.) / to reduce; to decrease; to discount / to shake off (water, etc.); to let drip-dry; to let drain / to cross; to traverse / to criticize sharply / to act decisively; to do (something noticeable); to go first; to make (certain facial expressions, in kabuki) / to turn (vehicle, steering wheel, etc.) / to curl (a ball); to bend; to cut / to shuffle (cards) / to discard a tile / to dismiss; to sack; to let go; to expulse; to excommunicate / to dig (a groove); to cut (a stencil, on a mimeograph) / to trump / to cut (the connection between two groups) (in go) / to start a fire (with wood-wood friction or by striking a metal against stone) / to draw (a shape) in the air (with a sword, etc.) / to finish; to complete
わたす	watasu	渡す	to ferry across (e.g. a river); to carry across; to traverse / to lay across; to build across / to hand over; to hand in; to pass; to give; to transfer
ふうとう	fuutou	封筒	envelope
まいあさ	maiasa	毎朝	every morning
ようふく	youfuku	洋服	Western-style clothes (cf. traditional Japanese clothes)
きいろ	kiiro	黄色	yellow; amber
おわる	owaru	終わる	to finish; to end; to close
こうさてん	kousaten	交差点	crossing; intersection
えんぴつ	enpitsu	鉛筆	pencil
とまる	tomaru	止まる	to stop (moving); to come to a stop / to stop (doing, working, being supplied); to come to a halt; to cease; to be stopped; to be suspended / to alight; to perch on
でる	deru	出る	to leave; to exit; to go out; to come out; to get out / to leave (on a journey); to depart; to start out; to set out / to move forward / to come to; to get to; to lead to; to reach / to appear; to come out; to emerge; to surface; to come forth; to turn up; to be found; to be detected; to be discovered; to be exposed; to show; to be exhibited; to be on display / to appear (in print); to be published; to be announced; to be issued; to be listed; to come out / to attend; to participate; to take part; to enter (an event); to play in; to perform / to be stated; to be expressed; to come up; to be brought up; to be raised / to sell / to exceed; to go over / to stick out; to protrude / to break out; to occur; to start; to originate / to be produced / to come from; to be derived from / to be given; to get; to receive; to be offered; to be provided; to be presented; to be submitted; to be handed in; to be turned in; to be paid / to answer (phone, door, etc.); to get / to assume (an attitude); to act; to behave / to pick up (speed, etc.); to gain / to flow (e.g. tears); to run; to bleed / to graduate
じょうず	jouzu	上手	skillful; skilled; proficient; good (at); adept; clever / flattery
よむ	yomu	読む	to read / to count / to guess; to predict; to read (someone's thoughts); to see (e.g. into someone's heart); to divine
せびろ	sebiro	背広	business suit
のむ	nomu	飲む	to drink; to gulp; to swallow; to take (medicine) / to smoke (tobacco) / to engulf; to overwhelm / to keep down; to suppress / to accept (e.g. demand, condition) / to make light of; to conceal
こうちゃ	koucha	紅茶	black tea
ななつ	nanatsu	七つ	seven
かりる	kariru	借りる	to borrow; to have a loan / to rent; to hire
しゅくだい	shukudai	宿題	homework; assignment / pending issue; unresolved problem; open question
はやい	hayai	早い	fast; quick; hasty; brisk / early (in the day, etc.); premature / (too) soon; not yet; (too) early / easy; simple; quick
たぶん	tabun	多分	perhaps; probably / generous; many; much; great
だれ	dare	誰	who
きる	kiru	着る	to wear (in modern Japanese, from the shoulders down); to put on / to bear (guilt, etc.)
はる	haru	張る	to stick; to paste; to affix / to stretch; to spread; to strain; to tighten; to put up (tent) / to form (e.g. ice on a pond) / to fill; to swell / to stick out; to put; to slap / to be expensive / to keep a watch on; to be on the lookout / to become one tile away from completion / to span; to generate
めがね	megane	眼鏡	glasses; eyeglasses; spectacles / judgment; judgement; discrimination; discernment; insight
うたう	utau	歌う	to sing / to sing (one's praises in a poem, etc.); to compose a poem; to recite a poem
ください	kudasai	下さい	please give me / please do for me
みる	miru	見る	to see; to look; to watch; to view; to observe / to look over; to look on; to assess; to examine; to judge / to look after; to keep an eye on; to take care of / to view (e.g. flowers, movie) / to try; to try out; to test / to see that...; to find that...
あかい	akai	赤い	red; crimson; scarlet; vermilion; vermillion / Red; communist / beautiful
ひくい	hikui	低い	low (rank, degree, value, content, quality, etc.) / low (position); close to the ground / short (height) / deep (voice); in a low key; low (volume)
しまる	shimaru	閉まる	to be shut; to close; to be closed / to be firm (of a body, face, etc.); to be well-knit / to be locked / to tighten; to be tightened / to become sober; to become tense
あつい	atsui	熱い	hot (thing) / passionate (feelings, etc.); ardent; hot (e.g. gaze) / hot (e.g. temper) / zealous; enthusiastic; fired up / intense; severe; extreme / hot (topic); of interest
かえす	kaesu	返す	to return (something); to restore; to put back / to turn over; to turn upside down; to overturn / to pay back; to retaliate; to reciprocate / to repeat ...; to do ... back
ひま	hima	暇	spare time; free time; leisure / time (e.g. time it takes to do something) / time off; day off; vacation; holiday; leave / quitting (one's job); firing someone; divorcing (one's spouse) / (of one's time) free; (of one's business) slow / leaving; departing
ちゃわん	chawan	茶碗	rice bowl; tea cup; teacup
でかける	dekakeru	出かける	to go out (e.g. on an excursion or outing); to leave; to depart; to start; to set out / to be about to leave; to be just going out
わかる	wakaru	分かる	to understand; to comprehend; to grasp; to see; to get; to follow / to become clear; to be known; to be discovered; to be realized; to be realised; to be found out
おまわりさん	omawarisan	お巡りさん	police officer
わるい	warui	悪い	bad; poor; inferior / evil; sinful / unprofitable; unbeneficial / at fault; to blame; in the wrong / sorry
あめ	ame	飴	(hard) candy; toffee / rice-sugar; sugar made from the starch of rice, potatoes, etc. / amber; yellowish-brown
やすい	yasui	安い	cheap; inexpensive / calm; peaceful; quiet
くらい	kurai	暗い	dark; gloomy; murky / depressed; dispirited; down in the dumps; dark (mood) / dark (in colour); dull / ill-boding; dark (e.g. past); suspicious / unlikely (to succeed); hopeless; unpromising / unfamiliar (with); ignorant (of)
やさしい	yasashii	易しい	easy; plain; simple
いす	isu	椅子	chair; stool / post; office; position
ちがう	chigau	違う	to differ (from); to vary / to not be in the usual condition / to not match the correct (answer, etc.) / to be different from promised / isn't it?; wasn't it?
いち	ichi	一	one / best / first; foremost / beginning; start / ace (playing card) / bottom string (on a shamisen, etc.)
およぐ	oyogu	泳ぐ	to swim
とおい	tooi	遠い	far; distant; far away; a long way off; in the distance / distant (past); remote (in time); remote; far-removed (in time) / distant (relationship or kinship); having little to do (with someone) / far (from something else in quality, degree, etc.); not similar; way off / hard (of hearing) / nearsighted
きたない	kitanai	汚い	dirty; filthy; foul; unclean / disordered; messy; untidy; poor (e.g. handwriting) / indecent (language, etc.); dirty; vulgar; coarse / dastardly; mean; base; underhanded / stingy; greedy
きいろい	kiiroi	黄色い	yellow / high-pitched (voice); shrill
へた	heta	下手	unskillful; poor; awkward / imprudent; untactful
いつ	itsu	何時	when; how soon
かようび	kayoubi	火曜日	Tuesday
かびん	kabin	花瓶	(flower) vase
あう	au	会う	to meet; to encounter; to see / to have an accident; to have a bad experience
はいざら	haizara	灰皿	ashtray
おぼえる	oboeru	覚える	to memorize; to memorise; to commit to memory; to learn by heart; to bear in mind; to remember / to learn; to pick up; to acquire / to feel / to think; to regard
たのしい	tanoshii	楽しい	enjoyable; fun; pleasant; happy; delightful
かかる	kakaru	掛かる	to take (a resource, e.g. time or money) / to hang / to come into view; to arrive / to come under (a contract, a tax) / to start (engines, motors) / to attend; to deal with; to handle / to have started to; to be on the verge of / to overlap (e.g. information in a manual); to cover / to (come) at / to be fastened / to be covered (e.g. with dust, a table-cloth, etc.) / to be caught in / to get a call / to depend on
さむい	samui	寒い	cold (e.g. weather) / uninteresting (esp. joke); lame; dull; weak; corny
あまい	amai	甘い	sweet-tasting; sweet; sugary; sugared / fragrant (smelling); sweet (music) / lightly salted; light in salt; not spicy / naive; overly optimistic; soft on; generous; indulgent; easy-going; lenient / half-hearted; not finished properly / insufficient; not satisfactory; inadequate; loose / mild / tempting; enticing; luring
あぶない	abunai	危ない	dangerous; risky; hazardous; perilous; precarious / in danger; in jeopardy; critical; grave; at risk / uncertain; unreliable; insecure; unsteady; doubtful / close (i.e. a close call); narrow
いくつ	ikutsu	幾つ	how many? / how old?
いくら	ikura	幾ら	how much?; how many? / even; even if
かえる	kaeru	帰る	to return; to come home; to go home; to go back / to leave / to get home; to get to home plate
おきる	okiru	起きる	to get up; to rise; to blaze up (fire) / to wake up; to be awake; to stay awake / to occur (usu. of unfavourable incidents); to happen; to take place
やすむ	yasumu	休む	to be absent; to take a day off / to rest; to have a break / to go to bed; to (lie down to) sleep; to turn in; to retire / to stop doing some ongoing activity for a time; to suspend business
すう	suu	吸う	to smoke; to breathe in; to inhale / to suck; to sip; to slurp / to absorb; to soak up / to kiss
つよい	tsuyoi	強い	strong; potent; competent; domineering; tough / strong; brawny; powerful; healthy; rugged / good (at); skilled; knowledgeable / being able to handle; know how to deal (with); durable (against); resistant (to); resilient / firm; rigid; solid / intense; strong; fierce; high / dependable; trustworthy
おしえる	oshieru	教える	to teach; to instruct / to tell; to inform / to preach
せまい	semai	狭い	narrow; confined; small; cramped / limited; narrow-minded; confining
まがる	magaru	曲がる	to bend; to curve; to warp; to wind; to twist / to turn / to be awry; to be askew; to be crooked
ちかい	chikai	近い	near; close; short (distance) / close (in time); soon / close (relationship); friendly; intimate / closely related / similar; likeworthy; almost the same
ここのつ	kokonotsu	九つ	nine
くつした	kutsushita	靴下	socks; sock; stockings; stocking
かるい	karui	軽い	light (i.e. not heavy); feeling light (i.e. offering little resistance, moving easily) / light (i.e. of foot); effortless; nimble; agile / non-serious; minor; unimportant; trivial / slight; small; gentle; soft; easy; lighthearted (e.g. joke) / easy; simple / indiscriminate
